27
18
15 16 16 16 16 16 16 16 16 16 16 16 16 16 16 16 16 16 16 16 16 16 16 16 16 16 17
18 0  0  0  0  0  0  0  0  12 14 0  0  0  0  0  0  0  0  0  0  0  0  0  0  0  19
18 0  1  2  3  6  12 14 0  0  0  0  0  0  0  0  0  0  0  0  0  0  0  0  0  0  19
18 4  0  0  0  0  0  0  0  12 14 0  0  0  0  0  0  0  0  4  0  0  0  0  0  0  19
18 12 13 13 13 13 13 13 13 13 13 13 13 13 13 13 13 13 13 13 13 13 13 13 14 0  19
18 0  0  0  0  0  0  0  0  0  0  0  0  0  0  0  0  0  0  0  0  0  12 14 0  0  19
18 0  0  0  0  0  0  0  0  0  0  0  0  0  0  0  0  0  0  0  0  12 14 0  0  0  19
18 5  0  0  0  0  0  0  0  0  0  0  0  0  0  0  0  0  0  0  12 14 0  0  0  0  19
18 12 13 14 0  12 13 14 0  0  0  0  0  0  0  0  0  0  0  12 14 0  0  0  5  12 19
18 12 14 0  0  12 13 14 0  0  0  0  0  0  0  0  0  0  12 14 0  0  0  0  12 14 19
18 12 14 0  0  0  12 14 12 13 13 13 14 0  0  0  0  12 14 0  0  0  0  12 14 0  19
18 12 13 14 0  0  12 14 0  0  0  0  0  0  0  0  0  0  0  0  0  0  12 14 0  0  19
18 12 13 14 0  12 13 14 0  0  0  0  0  0  0  0  0  0  0  0  0  12 14 0  0  0  19
18 12 13 14 0  12 13 14 0  0  0  0  0  12 13 14 0  0  0  0  12 14 0  0  0  0  19
18 0  0  4  0  0  0  12 14 0  0  0  0  0  0  0  0  0  0  12 14 0  0  0  0  0  19
18 12 13 13 13 13 13 14 0  0  0  0  0  0  0  0  0  0  12 14 0  0  0  0  0  0  19
18 5  0  0  0  0  0  0  0  12 14 0  0  0  0  5  0  0  0  0  0  0  0  12 14 0  19
20 21 21 21 21 21 21 21 21 21 21 21 21 21 21 21 21 21 21 21 21 21 21 21 21 21 22
